R   1920    1080 
NO ./bluestone.xpm
SO ./colorstone.xpm
WE ./mossy.xpm
EA ./greystone.xpm
S ./pillar.xpm
C 225,   30   ,    0
F 220    ,100  ,   0 

11111111111111111111111111111 
1000200000W000000000000002001
11020001110101011111011110001
11110111 1110101 101111010001
11111111 1111111 11111111111111
