R 1000 1000

NO ./bluestone.xpm
SO ./colorstone.xpm
WE ./mossy.xpm
EA ./greystone.xpm
S ./barrel.xpm

C 102,  255,  255
F 192,  192,  192







        1111111111111111111111111
        1000000000110000000000001
        1011000001110000002000001
        1001000000000000000000001
111111111011000001110000000000001
100000000000000011101111111111111
11110011111111011100000010001
11110011111111011101010010001
10000000000000000000000000001
10202020200000000000000000001
10000000000000000000000000001
10000001110001011111011110S01
10000001 1000101 101111010001 
11111111 1111111 111111111111