R 1900 200

NO ./liquidmet512.xpm
SO ./t_1_7_512.xpm
WE ./head512.xpm
EA ./hand512.xpm
S ./term512.xpm

C 0,  0,  0
F 0,  0,  0






        1111111111111111111111111
        1000000000110000000000001
        1011000001110000002000001
        1001000000000020000000001
111111111011000001110000000000001
100020000000000011101111111111111
11110011111111011100000010001
11110011111111011101010010001
10000000000002000000000000001
10202020200200020200000000001
10000000000002000200000000001
10000001110001011111011110W0111
10020001 1020101 101111010001 
11111111 1111111 111111111111