R   1920    1080 
NO ./bluestone.xpm
SO ./colorstone.xpm
WE ./mossy.xpm
EA ./greystone.xpm
S ./barrel.xpm
C 135,   206   ,  235
F 220    ,100,     0 

1111    1111111111111111111111111
1001    1000000000110002020202021
1111    1011000001110020202020201
        100120000000000N020202021
111111111011000001110000000000001
100000000011000001110111111111111
11110111111111011100001000001
11110111111111011101010010001
11000000110101011100000010001
10000000000000001100000010001
10000000000000001101010010001
11000001110101011111011110001
11110111 1110101 101111010001
11111111 1111111 11111111111111